*****
**.**
**S**
**.**
*****