**************************
*$$$$C  ^        GG  S %%*
** ^^^^ ^^ *** ****** ** *
*       %%%GG        GGGG*
**** ******G***** ^^^^^^^*
*G S       G           %%*
****** ^^^^^ **** ^^^^%*G*
*         %%%% G %%%   *G*
* ^^^**** ********** *****
* GG     G  ^^%  G    PW *
* *******G^^^^^^^G** *****
* G%%%    %%    GGG   %%%*
**************************