**************************
*S$ $     $$$   *    S$$$*
* * * *** *** *** * * ****
* $       *$*$*$* *$* ****
* ******* *S*$* *$*$*$*@**
* *$*$*$* * * * *$* *$* **
*                       C*
*$*$*$*$* ******* ****** *
* ******* *$$        $$* *
* *$ P $* *** *** ** *** *
* *** *** *   *** ** *** *
*$          *$   S     $$*
**************************