**************************
*$$$    *     $$$$   S   *
******* ** ********** ****
* $      $$$   $    $    *
**** ************ ********
*  S              $$     *
****** ***** ******** ****
* $$$           $        *
********* ********** *****
*    $$$            $    *
* *************** **** ***
*$*     $$$ P  $$  $     *
**************************