**************************
*$$$C   *     $$$$   S   *
** **** ** ********** ****
* $      $$$   $    $    *
**** ****** ***** ********
*  S              $$     *
****** ***** **** *** ****
* $$$           $        *
********* ********** *****
*    $$$            $    *
* ******* ******* **** ***
*$*     $$$ P  $$  $     *
**************************