**************************
*$$$$C  ^            S   *
** ^^^^ ^^ *** ****** ** *
*                        *
**** ****** ***** ^^^^^^^*
*  S                     *
****** ^^^^^ **** ^^^ ****
*                       @*
* ^^^**** ********** *****
*          !             *
* ******* ^^^^^^^ ^^^^ ***
* !       ! P           @*
**************************