**************************
*$$$$C  ^        GG  S %%*
** ^^^^ ^^ *** ****** ** *
*       %%%GG        GGGG*
**** ******G***** ^^^^^^^*
*G S       G           %%*
****** ^^^^^ **** ^^^%****
*         %%%% G %%%    @*
* ^^^**** ********** *****
* GG     G !  %  G     %%*
* *******G^^^^^^^G^^^^ ***
* !%%%    %%P   GGG     @*
**************************