**************************
*$$$$C  ^        GG  S %%*
** ^^^^ ^^ *** ****** ** *
*       %%%GG        GGGG*
**** ******G***** ^^^^^^^*
*G S       G           %%*
****** ^^^^^ **** ^^^%****
*         %%%% G %%%     *
* ^^^**** ********** *****
* GG     G !^^%  G    PW *
* *******G^^^^^^^G** *****
* !%%%    %%    GGG   %%%*
**************************