**************************
*$$$$C  ^        %%  S %%*
** ^^^^ ^^ *** ****** ** *
*       %%%              *
**** ****** ***** ^^^^^^^*
*  S                   %%*
****** ^^^^^ **** ^^^^%* *
*         %%%%   %%%   * *
* ^^^**** ********** *****
*           ^^%G      PW *
* ******* ^^^^^^^ ** *****
*  %%%    %%          %%%*
**************************