**************************
*$$$C   *     $$$$   S   *
** **** ** *** ****** ** *
* $      $$$   $    $    *
**** ****** ***** ********
*  S              $$     *
****** ***** **** *** ****
* $$$           $        *
********* ********** *****
*    $$$            $    *
* ******* ******* **** ***
*$      $$$ P  $$  $     *
**************************