**************************
*C     $$          $$   C*
* ^^^^ ^^^^^ ********* ^ *
* ^$$$$$$$$$@$$$$$$$$$$^ *
* ^$******** ***** ^^^^^ *
*        $$$           $$*
* ****** ^^^^^^ *** ***^$*
*    $$* ^$$    ***   $^$*
* * ^^$* ^$****     **$^$*
*   $^$* ^$$    ^^^   $^$*
* ****** ^^^^^^ ^^^^^^^^$*
*C$$      $$          $$P*
*^^^^^^^******************