**************************
*C     $$          $$   C*
* **** ***** ********* * *
* *$$$$$$$$$@$$$$$$$$$$* *
* *$******** ***** ***** *
*        $$$           $ *
* ****** ****** *** **** *
*    $$* *$$    ***   $* *
* * **$* *$****     **$* *
*   $*$* *$$    ***   $* *
* ****** ****** ******** *
*C$$      $$          $$P*
**************************