**************************
*$$$C   ^     $$$$   S   *
** ^^^^ ^^ *** ****** ** *
* $      $$$   $    $    *
**** ****** ***** ^^^^^^^*
*  S              $$     *
****** ^^^^^ **** ^^^ ****
* $$$           $       @*
* ^^^**** ********** *****
*    $$$   !        $    *
* ******* ^^^^^^^ ^^^^ ***
*$      $$$ P  $$  $     *
**************************