**************************
*$$$$C  ^            S %%*
** ^^^^ ^^ *** ****** ** *
*       %%%              *
**** ****** ***** ^^^^^^^*
*  S                   %%*
****** ^^^^^ **** ^^^%****
*         %%%%   %%%    @*
* ^^^**** ********** *****
*          !  %        %%*
* ******* ^^^^^^^ ^^^^ ***
* !%%%    %%P           @*
**************************