^^^^*********************^
^S$ $     $$$   *    S$$$^
^ * ^ ^^^ ^^^ *** * * ^^^^
* $       *$^$*$* *$* ^^^^
* *^^^^^^ *S^$* *$*$*$*@^^
* *$*$*$* * * * *$* *$* ^^
*                       C^
*$*$*$*$^ **^^*** ****** *
* ******^ *$$        $$* *
* *MP  $^ *^^ ^^^ ^^ ^^^ *
* *** ^^^ *   ^^^ ^^ ^^^ *
*$          *$   S     $$*
**************************